9 6
64 64
0 imagens\0.png
1 imagens\1.png
2 imagens\2.png
3 imagens\3.png
4 imagens\4.png
5 imagens\5.png
6 imagens\6.png
7 imagens\7.png
8 imagens\8.png
9 imagens\9.png
10 imagens\10.png
11 imagens\11.png
12 imagens\12.png
13 imagens\13.png
14 imagens\14.png
15 imagens\15.png
*
6 7 7 9 1 6 7 7 9 
6 7 7 9 2 6 7 7 9
6 7 7 9 0 6 7 7 9
10 11 12 13 0 10 11 12 13
0 0 2 0 1 2 1 2 0
3 4 5 0 1 1 3 4 5
*
1 1 1 1 0 1 1 1 1 
1 1 1 1 0 1 1 1 1
1 1 1 1 0 1 1 1 1
1 1 1 1 0 1 1 1 1
0 0 0 0 0 0 0 0 0
1 1 1 0 0 0 1 1 1
*
0 0 0 0 3 0 0 0 0 
0 0 0 0 4 0 0 0 0
0 0 0 0 4 0 0 0 0
0 0 0 0 4 0 0 0 0
3 0 0 4 4 4 0 0 3
0 0 0 2 2 2 0 0 0